b baba
k keke
r robot
p pipe
v violet

###################################
#  B                              #
# B=@  V&R=P&!                    #
# =^                              #
# *&   K=@ K=* K=. K=+ K=!        #
#  _   K=( K=) K=[ K=] K=^        #
#      K=_ K=> K=< K=, K=B K=K    #
#                                 #
###################################
